paper_name,paper_url,Title,Author,Journal,Loading,PMID,Doi,download_status
balance_00001,https://pubmed.ncbi.nlm.nih.gov/29472847/,Balance Training Reduces Brain Activity during Motor Simulation of a Challenging  Balance Task in Older Adults: An fMRI Study.,"Ruffieux J, Mouthon A, Keller M, Mouthon M, Annoni JM, Taube W",Frontiers in behavioral neuroscience,0.672,29472847,-1,-1
balance_00002,https://pubmed.ncbi.nlm.nih.gov/24480476/,Functional MR imaging of a simulated balance task.,"Karim HT, Sparto PJ, Aizenstein HJ, Furman JM, Huppert TJ, Erickson KI, Loughlin PJ",Brain research,0.636,24480476,-1,-1
balance_00003,https://pubmed.ncbi.nlm.nih.gov/24663383/,Using motor imagery to study the neural substrates of dynamic balance.,"Ferraye MU, Debu B, Heil L, Carpenter M, Bloem BR, Toni I",PloS one,0.616,24663383,-1,-1
balance_00004,https://pubmed.ncbi.nlm.nih.gov/20614202/,Sustained cortical and subcortical neuromodulation induced by electrical tongue stimulation.,"Wildenberg JC, Tyler ME, Danilov YP, Kaczmarek KA, Meyerand ME",Brain imaging and behavior,0.593,20614202,-1,-1
balance_00005,https://pubmed.ncbi.nlm.nih.gov/25461711/,Brain activity during observation and motor imagery of different balance tasks: An fMRI study.,"Taube W, Mouthon M, Leukel C, Hoogewoud HM, Annoni JM, Keller M",Cortex; a journal devoted to the study of the nervous system and behavior,0.551,25461711,-1,-1
balance_00006,https://pubmed.ncbi.nlm.nih.gov/24647435/,Localizing evoked cortical activity associated with balance reactions: does the anterior cingulate play a role?,"Marlin A, Mochizuki G, Staines WR, McIlroy WE",Journal of neurophysiology,0.534,24647435,-1,-1
balance_00007,https://pubmed.ncbi.nlm.nih.gov/22072686/,Brain activity during ankle proprioceptive stimulation predicts balance performance in young and older adults.,"Goble DJ, Coxon JP, Van Impe A, Geurts M, Doumas M, Wenderoth N, Swinnen SP",The Journal of neuroscience : the official journal of the Society for Neuroscience,0.524,22072686,-1,-1
balance_00008,https://pubmed.ncbi.nlm.nih.gov/27779907/,The Neurocognitive Cost of Enhancing Cognition with Methylphenidate: Improved Distractor Resistance but Impaired Updating.,"Fallon SJ, van der Schaaf ME, Ter Huurne N, Cools R",Journal of cognitive neuroscience,0.364,27779907,-1,-1
balance_00009,https://pubmed.ncbi.nlm.nih.gov/25191858/,Interhemispheric cerebral blood flow balance during recovery of motor hand function after ischemic stroke--a longitudinal MRI study using arterial spin labeling perfusion.,"Wiest R, Abela E, Missimer J, Schroth G, Hess CW, Sturzenegger M, Wang DJ, Weder B, Federspiel A",PloS one,0.295,25191858,-1,-1
balance_00010,https://pubmed.ncbi.nlm.nih.gov/29230170/,The Dancing Brain: Structural and Functional Signatures of Expert Dance Training.,"Burzynska AZ, Finc K, Taylor BK, Knecht AM, Kramer AF",Frontiers in human neuroscience,0.286,29230170,-1,-1
balance_00011,https://pubmed.ncbi.nlm.nih.gov/23419940/,Functional brain imaging of multi-sensory vestibular processing during computerized dynamic posturography using near-infrared spectroscopy.,"Karim H, Fuhrman SI, Sparto P, Furman J, Huppert T",NeuroImage,0.284,23419940,10.1016/j.neuroimage.2013.02.010,-1
balance_00012,https://pubmed.ncbi.nlm.nih.gov/24825503/,Dorsomedial striatum involvement in regulating conflict between current and presumed outcomes.,"Mestres-Misse A, Bazin PL, Trampel R, Turner R, Kotz SA",NeuroImage,0.243,24825503,10.1016/j.neuroimage.2014.05.002,-1
balance_00013,https://pubmed.ncbi.nlm.nih.gov/16404736/,Common deactivation patterns during working memory and visual attention tasks: an intra-subject fMRI study at 4 Tesla.,"Tomasi D, Ernst T, Caparelli EC, Chang L",Human brain mapping,0.225,16404736,10.1002/hbm.20211,-1
balance_00014,https://pubmed.ncbi.nlm.nih.gov/28893930/,How Human Amygdala and Bed Nucleus of the Stria Terminalis May Drive Distinct Defensive Responses.,"Klumpers F, Kroes MCW, Baas JMP, Fernandez G",The Journal of neuroscience : the official journal of the Society for Neuroscience,0.225,28893930,10.1523/JNEUROSCI.3830-16.2017,-1
balance_00015,https://pubmed.ncbi.nlm.nih.gov/21496490/,High-resolution fMRI detects neuromodulation of individual brainstem nuclei by electrical tongue stimulation in balance-impaired individuals.,"Wildenberg JC, Tyler ME, Danilov YP, Kaczmarek KA, Meyerand ME",NeuroImage,0.217,21496490,10.1016/j.neuroimage.2011.03.074,-1
balance_00016,https://pubmed.ncbi.nlm.nih.gov/26786152/,Altered balance of functional brain networks in Schizophrenia.,"Woodward TS, Leong K, Sanford N, Tipper CM, Lavigne KM",Psychiatry research. Neuroimaging,0.213,26786152,-1,-1
balance_00017,https://pubmed.ncbi.nlm.nih.gov/22390465/,Age-related neural reorganization during spoken word recognition: the interaction of form and meaning.,"Shafto M, Randall B, Stamatakis EA, Wright P, Tyler LK",Journal of cognitive neuroscience,0.199,22390465,-1,-1
balance_00018,https://pubmed.ncbi.nlm.nih.gov/28189743/,Glutamatergic metabolites are associated with visual plasticity in humans.,"Wijtenburg SA, West J, Korenic SA, Kuhney F, Gaston FE, Chen H, Roberts M, Kochunov P, Hong LE, Rowland LM",Neuroscience letters,0.195,28189743,-1,-1
balance_00019,https://pubmed.ncbi.nlm.nih.gov/19702469/,The unrested resting brain: sleep deprivation alters activity within the default-mode network.,"Gujar N, Yoo SS, Hu P, Walker MP",Journal of cognitive neuroscience,0.185,19702469,-1,-1
balance_00020,https://pubmed.ncbi.nlm.nih.gov/23201365/,"Caloric deprivation increases responsivity of attention and reward brain regions  to intake, anticipated intake, and images of palatable foods.","Stice E, Burger K, Yokum S",NeuroImage,0.181,23201365,-1,-1
balance_00021,https://pubmed.ncbi.nlm.nih.gov/25447301/,"The effects of energy balance, obesity-proneness and sex on the neuronal response to sweet taste.","Cornier MA, Shott ME, Thomas EA, Bechtell JL, Bessesen DH, Tregellas JR, Frank GK",Behavioural brain research,0.167,25447301,-1,-1
balance_00022,https://pubmed.ncbi.nlm.nih.gov/17315226/,Sex specificity of ventral anterior cingulate cortex suppression during a cognitive task.,"Butler T, Imperato-McGinley J, Pan H, Voyer D, Cunningham-Bussel AC, Chang L, Zhu YS, Cordero JJ, Stern E, Silbersweig D",Human brain mapping,0.165,17315226,-1,-1
balance_00023,https://pubmed.ncbi.nlm.nih.gov/24155301/,Affective modulation of cognitive control is determined by performance-contingency and mediated by ventromedial prefrontal and cingulate cortex.,"Braem S, King JA, Korb FM, Krebs RM, Notebaert W, Egner T",The Journal of neuroscience : the official journal of the Society for Neuroscience,0.159,24155301,-1,-1
balance_00024,https://pubmed.ncbi.nlm.nih.gov/27071087/,Contrasting variability patterns in the default mode and sensorimotor networks balance in bipolar depression and mania.,"Martino M, Magioncalda P, Huang Z, Conio B, Piaggio N, Duncan NW, Rocchi G, Escelsior A, Marozzi V, Wolff A, Inglese M, Amore M, Northoff G",Proceedings of the National Academy of Sciences of the United States of America,0.155,27071087,-1,-1
balance_00025,https://pubmed.ncbi.nlm.nih.gov/27358453/,"Gain in Body Fat Is Associated with Increased Striatal Response to Palatable Food Cues, whereas Body Fat Stability Is Associated with Decreased Striatal Response.","Stice E, Yokum S",The Journal of neuroscience : the official journal of the Society for Neuroscience,0.147,27358453,-1,-1
balance_00026,https://pubmed.ncbi.nlm.nih.gov/24893741/,Done that: short-term repetition related modulations of motor cortex activity as  a stable signature for overnight motor memory consolidation.,"Gabitov E, Manor D, Karni A",Journal of cognitive neuroscience,0.145,24893741,-1,-1
balance_00027,https://pubmed.ncbi.nlm.nih.gov/28066207/,Diurnal Variations in Neural Activity of Healthy Human Brain Decoded with Resting-State Blood Oxygen Level Dependent fMRI.,"Jiang C, Yi L, Su S, Shi C, Long X, Xie G, Zhang L",Frontiers in human neuroscience,0.137,28066207,-1,-1
balance_00028,https://pubmed.ncbi.nlm.nih.gov/25393934/,Effects of overnight fasting on working memory-related brain network: An fMRI study.,"Chechko N, Vocke S, Habel U, Toygar T, Kuckartz L, Berthold-Losleben M, Laoutidis ZG, Orfanos S, Wassenberg A, Karges W, Schneider F, Kohn N",Human brain mapping,0.135,25393934,-1,-1
balance_00029,https://pubmed.ncbi.nlm.nih.gov/24760850/,"Source-reconstruction of event-related fields reveals hyperfunction and hypofunction of cortical circuits in antipsychotic-naive, first-episode schizophrenia patients during Mooney face processing.","Rivolta D, Castellanos NP, Stawowsky C, Helbling S, Wibral M, Grutzner C, Koethe D, Birkner K, Kranaster L, Enning F, Singer W, Leweke FM, Uhlhaas PJ",The Journal of neuroscience : the official journal of the Society for Neuroscience,0.133,24760850,-1,-1
balance_00030,https://pubmed.ncbi.nlm.nih.gov/27318136/,Effects of aging on task- and stimulus-related cerebral attention networks.,"Kurth S, Majerus S, Bastin C, Collette F, Jaspar M, Bahri MA, Salmon E",Neurobiology of aging,0.133,27318136,-1,-1
balance_00031,https://pubmed.ncbi.nlm.nih.gov/29751242/,"Local functional connectivity alterations in schizophrenia, bipolar disorder, and major depressive disorder.","Wei Y, Chang M, Womer FY, Zhou Q, Yin Z, Wei S, Zhou Y, Jiang X, Yao X, Duan J, Xu K, Zuo XN, Tang Y, Wang F",Journal of affective disorders,0.132,29751242,10.1016/j.jad.2018.04.069,-1
balance_00032,https://pubmed.ncbi.nlm.nih.gov/25107854/,Estimating time-varying brain connectivity networks from functional MRI time series.,"Monti RP, Hellyer P, Sharp D, Leech R, Anagnostopoulos C, Montana G",NeuroImage,0.129,25107854,10.1016/j.neuroimage.2014.07.033,-1
balance_00033,https://pubmed.ncbi.nlm.nih.gov/18358742/,Mapping the involvement of BA 4a and 4p during Motor Imagery.,"Sharma N, Jones PS, Carpenter TA, Baron JC",NeuroImage,0.128,18358742,-1,-1
balance_00034,https://pubmed.ncbi.nlm.nih.gov/15784428/,The many faces of the gamma band response to complex visual stimuli.,"Lachaux JP, George N, Tallon-Baudry C, Martinerie J, Hugueville L, Minotti L, Kahane P, Renault B",NeuroImage,0.126,15784428,-1,-1
balance_00035,https://pubmed.ncbi.nlm.nih.gov/23664619/,Social manipulation of preference in the human brain.,"Izuma K, Adolphs R",Neuron,0.124,23664619,-1,-1
balance_00036,https://pubmed.ncbi.nlm.nih.gov/20092563/,Physical and motor fitness are both related to cognition in old age.,"Voelcker-Rehage C, Godde B, Staudinger UM",The European journal of neuroscience,0.123,20092563,-1,-1
balance_00037,https://pubmed.ncbi.nlm.nih.gov/23220493/,The connectivity of functional cores reveals different degrees of segregation and integration in the brain at rest.,"de Pasquale F, Sabatini U, Della Penna S, Sestieri C, Caravasso CF, Formisano R, Peran P",NeuroImage,0.123,23220493,-1,-1
balance_00038,https://pubmed.ncbi.nlm.nih.gov/22847930/,Excitatory and inhibitory mechanisms underlying somatosensory habituation.,"Klingner CM, Hasler C, Brodoehl S, Witte OW",Human brain mapping,0.121,22847930,-1,-1
balance_00039,https://pubmed.ncbi.nlm.nih.gov/27791015/,"Overdrinking, swallowing inhibition, and regional brain responses prior to swallowing.","Saker P, Farrell MJ, Egan GF, McKinley MJ, Denton DA",Proceedings of the National Academy of Sciences of the United States of America,0.121,27791015,-1,-1
balance_00040,https://pubmed.ncbi.nlm.nih.gov/20107076/,When desire collides with reason: functional interactions between anteroventral prefrontal cortex and nucleus accumbens underlie the human ability to resist impulsive desires.,"Diekhof EK, Gruber O",The Journal of neuroscience : the official journal of the Society for Neuroscience,0.118,20107076,-1,-1
balance_00041,https://pubmed.ncbi.nlm.nih.gov/22617829/,An anterior-posterior gradient of cognitive control within the dorsomedial striatum.,"Mestres-Misse A, Turner R, Friederici AD",NeuroImage,0.116,22617829,10.1016/j.neuroimage.2012.05.021,-1
balance_00042,https://pubmed.ncbi.nlm.nih.gov/24893740/,Reward acts on the pFC to enhance distractor resistance of working memory representations.,"Fallon SJ, Cools R",Journal of cognitive neuroscience,0.116,24893740,10.1162/jocn_a_00676,-1
balance_00043,https://pubmed.ncbi.nlm.nih.gov/24478664/,Frontopolar cortex and decision-making efficiency: comparing brain activity of experts with different professional background during an exploration-exploitation task.,"Laureiro-Martinez D, Canessa N, Brusoni S, Zollo M, Hare T, Alemanno F, Cappa SF",Frontiers in human neuroscience,0.114,24478664,10.3389/fnhum.2013.00927,-1
balance_00044,https://pubmed.ncbi.nlm.nih.gov/17662257/,Knowing when to stop: the brain mechanisms of chasing losses.,"Campbell-Meiklejohn DK, Woolrich MW, Passingham RE, Rogers RD",Biological psychiatry,0.113,17662257,-1,-1
balance_00045,https://pubmed.ncbi.nlm.nih.gov/24403145/,The control of global brain dynamics: opposing actions of frontoparietal control  and default mode networks on attention.,"Hellyer PJ, Shanahan M, Scott G, Wise RJ, Sharp DJ, Leech R",The Journal of neuroscience : the official journal of the Society for Neuroscience,0.113,24403145,-1,-1
balance_00046,https://pubmed.ncbi.nlm.nih.gov/18465748/,Differential cerebellar and cortical involvement according to various attentional load: role of educational level.,"Bonnet MC, Dilharreguy B, Allard M, Deloire MS, Petry KG, Brochet B",Human brain mapping,0.111,18465748,-1,-1
balance_00047,https://pubmed.ncbi.nlm.nih.gov/20682349/,The changes in brain metabolism in people with activated brown adipose tissue: a  PET study.,"Huang YC, Hsu CC, Huang P, Yin TK, Chiu NT, Wang PW, Huang SH, Huang YE",NeuroImage,0.111,20682349,-1,-1
balance_00048,https://pubmed.ncbi.nlm.nih.gov/17418591/,Neural mechanisms of auditory awareness underlying verbal transformations.,"Kondo HM, Kashino M",NeuroImage,0.109,17418591,-1,-1
balance_00049,https://pubmed.ncbi.nlm.nih.gov/24564471/,Activity in the nucleus accumbens and amygdala underlies individual differences in prosocial and individualistic economic choices.,"Haruno M, Kimura M, Frith CD",Journal of cognitive neuroscience,0.109,24564471,-1,-1
balance_00050,https://pubmed.ncbi.nlm.nih.gov/25184505/,GABA concentration in posterior cingulate cortex predicts putamen response during resting state fMRI.,"Arrubla J, Tse DH, Amkreutz C, Neuner I, Shah NJ",PloS one,0.106,25184505,-1,-1
balance_00051,https://pubmed.ncbi.nlm.nih.gov/29471098/,The role of effective connectivity between the task-positive and task-negative network for evidence gathering [Evidence gathering and connectivity].,"Andreou C, Steinmann S, Kolbeck K, Rauh J, Leicht G, Moritz S, Mulert C",NeuroImage,0.106,29471098,-1,-1
balance_00052,https://pubmed.ncbi.nlm.nih.gov/24302681/,The neurosteroids allopregnanolone and dehydroepiandrosterone modulate resting-state amygdala connectivity.,"Sripada RK, Welsh RC, Marx CE, Liberzon I",Human brain mapping,0.105,24302681,-1,-1
balance_00053,https://pubmed.ncbi.nlm.nih.gov/18486490/,Dynamic intra- and interhemispheric interactions during unilateral and bilateral  hand movements assessed with fMRI and DCM.,"Grefkes C, Eickhoff SB, Nowak DA, Dafotakis M, Fink GR",NeuroImage,0.104,18486490,-1,-1
balance_00054,https://pubmed.ncbi.nlm.nih.gov/21840340/,Human avoidance and approach learning: evidence for overlapping neural systems and experiential avoidance modulation of avoidance neurocircuitry.,"Schlund MW, Magee S, Hudgins CD",Behavioural brain research,0.104,21840340,-1,-1
balance_00055,https://pubmed.ncbi.nlm.nih.gov/11960021/,The neural system that bridges reward and cognition in humans: an fMRI study.,"Pochon JB, Levy R, Fossati P, Lehericy S, Poline JB, Pillon B, Le Bihan D, Dubois B",Proceedings of the National Academy of Sciences of the United States of America,0.102,11960021,-1,-1
balance_00056,https://pubmed.ncbi.nlm.nih.gov/17451973/,Central control of grasp: manipulation of objects with complex and simple dynamics.,"Milner TE, Franklin DW, Imamizu H, Kawato M",NeuroImage,0.102,17451973,-1,-1
balance_00057,https://pubmed.ncbi.nlm.nih.gov/19636426/,The effects of overfeeding on the neuronal response to visual food cues in thin and reduced-obese individuals.,"Cornier MA, Salzberg AK, Endly DC, Bessesen DH, Rojas DC, Tregellas JR",PloS one,0.1,19636426,-1,-1
balance_00058,https://pubmed.ncbi.nlm.nih.gov/24814210/,Audio-visual synchrony modulates the ventriloquist illusion and its neural/spatial representation in the auditory cortex.,"Bonath B, Noesselt T, Krauel K, Tyll S, Tempelmann C, Hillyard SA",NeuroImage,0.099,24814210,-1,-1
balance_00059,https://pubmed.ncbi.nlm.nih.gov/29425803/,Exogenous vs. endogenous attention: Shifting the balance of fronto-parietal activity.,"Meyer KN, Du F, Parks E, Hopfinger JB",Neuropsychologia,0.099,29425803,-1,-1
balance_00060,https://pubmed.ncbi.nlm.nih.gov/22892422/,Being and feeling in sync with an adaptive virtual partner: brain mechanisms underlying dynamic cooperativity.,"Fairhurst MT, Janata P, Keller PE","Cerebral cortex (New York, N.Y. : 1991)",0.098,22892422,-1,-1
balance_00061,https://pubmed.ncbi.nlm.nih.gov/23483978/,Altered fronto-striatal and fronto-cerebellar circuits in heroin-dependent individuals: a resting-state FMRI study.,"Wang Y, Zhu J, Li Q, Li W, Wu N, Zheng Y, Chang H, Chen J, Wang W",PloS one,0.096,23483978,10.1371/journal.pone.0058098,-1
balance_00062,https://pubmed.ncbi.nlm.nih.gov/21051105/,Aging of human supraspinal locomotor and postural control in fMRI.,"Zwergal A, Linn J, Xiong G, Brandt T, Strupp M, Jahn K",Neurobiology of aging,0.094,21051105,10.1016/j.neurobiolaging.2010.09.022,-1
balance_00063,https://pubmed.ncbi.nlm.nih.gov/21596764/,Neural contributions to flow experience during video game playing.,"Klasen M, Weber R, Kircher TT, Mathiak KA, Mathiak K",Social cognitive and affective neuroscience,0.094,21596764,10.1093/scan/nsr021,-1
balance_00064,https://pubmed.ncbi.nlm.nih.gov/24887402/,Effects of healthy ageing on activation pattern within the primary motor cortex during movement and motor imagery: an fMRI study.,"Sharma N, Baron JC",PloS one,0.094,24887402,-1,-1
balance_00065,https://pubmed.ncbi.nlm.nih.gov/19883772/,Emotional priming effects during Stroop task performance.,"Hart SJ, Green SR, Casp M, Belger A",NeuroImage,0.093,19883772,-1,-1
balance_00066,https://pubmed.ncbi.nlm.nih.gov/25037922/,The Neural Representation of Voluntary Task-Set Selection in Dynamic Environments.,"Wisniewski D, Reverberi C, Tusche A, Haynes JD","Cerebral cortex (New York, N.Y. : 1991)",0.092,25037922,-1,-1
balance_00067,https://pubmed.ncbi.nlm.nih.gov/28344549/,Functional Brain Activation in Response to a Clinical Vestibular Test Correlates  with Balance.,"Noohi F, Kinnaird C, DeDios Y, Kofman IS, Wood S, Bloomberg J, Mulavara A, Seidler R",Frontiers in systems neuroscience,0.092,28344549,-1,-1
balance_00068,https://pubmed.ncbi.nlm.nih.gov/25767441/,Propensity to obesity impacts the neuronal response to energy imbalance.,"Cornier MA, McFadden KL, Thomas EA, Bechtell JL, Bessesen DH, Tregellas JR",Frontiers in behavioral neuroscience,0.091,25767441,-1,-1
balance_00069,https://pubmed.ncbi.nlm.nih.gov/23505435/,Early and phasic cortical metabolic changes in vestibular neuritis onset.,"Alessandrini M, Pagani M, Napolitano B, Micarelli A, Candidi M, Bruno E, Chiaravalloti A, Di Pietro B, Schillaci O",PloS one,0.09,23505435,-1,-1
balance_00070,https://pubmed.ncbi.nlm.nih.gov/27192082/,Task and Resting-State fMRI Reveal Altered Salience Responses to Positive Stimuli in Patients with Major Depressive Disorder.,"Yang Y, Zhong N, Imamura K, Lu S, Li M, Zhou H, Li H, Yang X, Wan Z, Wang G, Hu B, Li K",PloS one,0.09,27192082,-1,-1
balance_00071,https://pubmed.ncbi.nlm.nih.gov/27504261/,Disrupted functional connectivity in adolescent obesity.,"Moreno-Lopez L, Contreras-Rodriguez O, Soriano-Mas C, Stamatakis EA, Verdejo-Garcia A",NeuroImage. Clinical,0.09,27504261,-1,-1
balance_00072,https://pubmed.ncbi.nlm.nih.gov/19780042/,Sensory-motor brain network connectivity for speech comprehension.,"Londei A, D'Ausilio A, Basso D, Sestieri C, Gratta CD, Romani GL, Belardinelli MO",Human brain mapping,0.087,19780042,-1,-1
balance_00073,https://pubmed.ncbi.nlm.nih.gov/27590722/,Working memory load influences perceptual ambiguity by competing for fronto-parietal attentional resources.,"Intaite M, Duarte JV, Castelo-Branco M",Brain research,0.086,27590722,-1,-1
balance_00074,https://pubmed.ncbi.nlm.nih.gov/23507378/,Spontaneous EEG alpha oscillation interacts with positive and negative BOLD responses in the visual-auditory cortices and default-mode network.,"Mayhew SD, Ostwald D, Porcaro C, Bagshaw AP",NeuroImage,0.085,23507378,-1,-1
balance_00075,https://pubmed.ncbi.nlm.nih.gov/27626634/,From Cortical and Subcortical Grey Matter Abnormalities to Neurobehavioral Phenotype of Angelman Syndrome: A Voxel-Based Morphometry Study.,"Aghakhanyan G, Bonanni P, Randazzo G, Nappi S, Tessarotto F, De Martin L, Frijia F, De Marchi D, De Masi F, Kuppers B, Lombardo F, Caramella D, Montanaro D",PloS one,0.085,27626634,-1,-1
balance_00076,https://pubmed.ncbi.nlm.nih.gov/28040541/,Cognitive emotion regulation modulates the balance of competing influences on ventral striatal aversive prediction error signals.,"Mulej Bratec S, Xie X, Wang Y, Schilbach L, Zimmer C, Wohlschlager AM, Riedl V, Sorg C",NeuroImage,0.085,28040541,-1,-1
balance_00077,https://pubmed.ncbi.nlm.nih.gov/16300966/,Brain correlates of negative and positive visuospatial priming in adults.,"Wright CI, Keuthen NJ, Savage CR, Martis B, Williams D, Wedig M, McMullin K, Rauch SL",NeuroImage,0.084,16300966,-1,-1
balance_00078,https://pubmed.ncbi.nlm.nih.gov/24198777/,Shifted intrinsic connectivity of central executive and salience network in borderline personality disorder.,"Doll A, Sorg C, Manoliu A, Woller A, Meng C, Forstl H, Zimmer C, Wohlschlager AM, Riedl V",Frontiers in human neuroscience,0.084,24198777,-1,-1
balance_00079,https://pubmed.ncbi.nlm.nih.gov/25644499/,The neural basis of impulsive discounting in pathological gamblers.,"Miedl SF, Wiswede D, Marco-Pallares J, Ye Z, Fehr T, Herrmann M, Munte TF",Brain imaging and behavior,0.084,25644499,-1,-1
balance_00080,https://pubmed.ncbi.nlm.nih.gov/26696853/,Role of the Insula and Vestibular System in Patients with Chronic Subjective Dizziness: An fMRI Study Using Sound-Evoked Vestibular Stimulation.,"Indovina I, Riccelli R, Chiarella G, Petrolo C, Augimeri A, Giofre L, Lacquaniti F, Staab JP, Passamonti L",Frontiers in behavioral neuroscience,0.084,26696853,-1,-1
balance_00081,https://pubmed.ncbi.nlm.nih.gov/27491682/,Prefrontal activity decline in women under a single dose of diazepam during rule-guided responses: an fMRI study.,"Munoz-Torres Z, Armony JL, Trejo-Martinez D, Conde R, Corsi-Cabrera M",Experimental brain research,0.084,27491682,10.1007/s00221-016-4746-x,-1
balance_00082,https://pubmed.ncbi.nlm.nih.gov/23986240/,Working memory and anticipatory set modulate midbrain and putamen activity.,"Yu Y, FitzGerald TH, Friston KJ",The Journal of neuroscience : the official journal of the Society for Neuroscience,0.082,23986240,10.1523/JNEUROSCI.1176-13.2013,-1
balance_00083,https://pubmed.ncbi.nlm.nih.gov/29527483/,Age-related functional brain changes in FMR1 premutation carriers.,"Brown SSG, Basu S, Whalley HC, Kind PC, Stanfield AC",NeuroImage. Clinical,0.082,29527483,-1,-1
balance_00084,https://pubmed.ncbi.nlm.nih.gov/22905821/,"Intrinsic architecture underlying the relations among the default, dorsal attention, and frontoparietal control networks of the human brain.","Spreng RN, Sepulcre J, Turner GR, Stevens WD, Schacter DL",Journal of cognitive neuroscience,0.081,22905821,-1,-1
balance_00085,https://pubmed.ncbi.nlm.nih.gov/24501355/,The role of the striatum in effort-based decision-making in the absence of reward.,"Schouppe N, Demanet J, Boehler CN, Ridderinkhof KR, Notebaert W",The Journal of neuroscience : the official journal of the Society for Neuroscience,0.081,24501355,-1,-1
balance_00086,https://pubmed.ncbi.nlm.nih.gov/23529005/,Enriched Encoding: Reward Motivation Organizes Cortical Networks for Hippocampal  Detection of Unexpected Events.,"Murty VP, Adcock RA","Cerebral cortex (New York, N.Y. : 1991)",0.08,23529005,-1,-1
balance_00087,https://pubmed.ncbi.nlm.nih.gov/22828162/,Prediction of SSRI treatment response in major depression based on serotonin transporter interplay between median raphe nucleus and projection areas.,"Lanzenberger R, Kranz GS, Haeusler D, Akimova E, Savli M, Hahn A, Mitterhauser M, Spindelegger C, Philippe C, Fink M, Wadsak W, Karanikas G, Kasper S",NeuroImage,0.079,22828162,-1,-1
balance_00088,https://pubmed.ncbi.nlm.nih.gov/22424873/,Abnormal functional connectivity between the anterior cingulate and the default mode network in drug-naive boys with attention deficit hyperactivity disorder.,"Sun L, Cao Q, Long X, Sui M, Cao X, Zhu C, Zuo X, An L, Song Y, Zang Y, Wang Y",Psychiatry research,0.077,22424873,-1,-1
balance_00089,https://pubmed.ncbi.nlm.nih.gov/26110429/,Dissociating Two Stages of Preparation in the Stop Signal Task Using fMRI.,"Chevrier A, Cheyne D, Graham S, Schachar R",PloS one,0.072,26110429,-1,-1
balance_00090,https://pubmed.ncbi.nlm.nih.gov/22957019/,Approach-bias predicts development of cannabis problem severity in heavy cannabis users: results from a prospective FMRI study.,"Cousijn J, Goudriaan AE, Ridderinkhof KR, van den Brink W, Veltman DJ, Wiers RW",PloS one,0.071,22957019,-1,-1
balance_00091,https://pubmed.ncbi.nlm.nih.gov/23750133/,Prefrontal inhibition of threat processing reduces working memory interference.,"Clarke R, Johnstone T",Frontiers in human neuroscience,0.07,23750133,-1,-1
balance_00092,https://pubmed.ncbi.nlm.nih.gov/27132070/,Intrinsic functional connectivity predicts individual differences in distractibility.,"Poole VN, Robinson ME, Singleton O, DeGutis J, Milberg WP, McGlinchey RE, Salat DH, Esterman M",Neuropsychologia,0.069,27132070,-1,-1
balance_00093,https://pubmed.ncbi.nlm.nih.gov/26600385/,Sex Differences in the Default Mode Network with Regard to Autism Spectrum Traits: A Resting State fMRI Study.,"Jung M, Mody M, Saito DN, Tomoda A, Okazawa H, Wada Y, Kosaka H",PloS one,0.068,26600385,-1,-1
balance_00094,https://pubmed.ncbi.nlm.nih.gov/12513941/,Prefrontal-posterior parietal networks in schizophrenia: primary dysfunctions and secondary compensations.,"Quintana J, Wong T, Ortiz-Portillo E, Kovalik E, Davidson T, Marder SR, Mazziotta JC",Biological psychiatry,0.066,12513941,-1,-1
balance_00095,https://pubmed.ncbi.nlm.nih.gov/29220349/,Neural correlates of motor-cognitive dual-tasking in young and old adults.,"Papegaaij S, Hortobagyi T, Godde B, Kaan WA, Erhard P, Voelcker-Rehage C",PloS one,0.065,29220349,-1,-1
balance_00096,https://pubmed.ncbi.nlm.nih.gov/26095953/,Persistency and flexibility of complex brain networks underlie dual-task interference.,"Alavash M, Hilgetag CC, Thiel CM, Giessing C",Human brain mapping,0.064,26095953,-1,-1
balance_00097,https://pubmed.ncbi.nlm.nih.gov/28069917/,Dopamine Modulates the Functional Organization of the Orbitofrontal Cortex.,"Kahnt T, Tobler PN",The Journal of neuroscience : the official journal of the Society for Neuroscience,0.061,28069917,-1,-1
balance_00098,https://pubmed.ncbi.nlm.nih.gov/18262208/,Perception of biological motion in autism spectrum disorders.,"Freitag CM, Konrad C, Haberlen M, Kleser C, von Gontard A, Reith W, Troje NF, Krick C",Neuropsychologia,0.06,18262208,-1,-1
balance_00099,https://pubmed.ncbi.nlm.nih.gov/28115477/,"A Deletion Variant of the alpha2b-Adrenoceptor Modulates the Stress-Induced Shift from ""Cognitive"" to ""Habit"" Memory.","Wirz L, Wacker J, Felten A, Reuter M, Schwabe L",The Journal of neuroscience : the official journal of the Society for Neuroscience,0.054,28115477,-1,-1
